{
    "name": "1. Learn All Keys",
    "patterns": [
        [1,0,0,0,0,0,0,0,0],
        [0,1,0,0,0,0,0,0,0],
        [0,0,1,0,0,0,0,0,0],
        [0,0,0,1,0,0,0,0,0],
        [0,0,0,0,1,0,0,0,0],
        [0,0,0,0,0,1,0,0,0],
        [0,0,0,0,0,0,1,0,0],
        [0,0,0,0,0,0,0,1,0],
        [0,0,0,0,0,0,0,0,1],
        [0,0,0,0,0,0,0,0,1],
        [0,0,0,0,0,0,0,1,0],
        [0,0,0,0,0,0,1,0,0],
        [0,0,0,0,0,1,0,0,0],
        [0,0,0,0,1,0,0,0,0],
        [0,0,0,1,0,0,0,0,0],
        [0,0,1,0,0,0,0,0,0],
        [0,1,0,0,0,0,0,0,0],
        [1,0,0,0,0,0,0,0,0]
    ],
    "ranks": [10, 15, 20]
}
