{
    "name": "10. Ode to Joy",
    "patterns": [
      [0,0,1,0,0,0,0,0,0],
      [0,0,1,0,0,0,0,0,0],
      [0,0,0,1,0,0,0,0,0],
      [0,0,0,0,1,0,0,0,0],
      [0,0,0,0,1,0,0,0,0],
      [0,0,0,1,0,0,0,0,0],
      [0,0,1,0,0,0,0,0,0],
      [0,1,0,0,0,0,0,0,0],
      [1,0,0,0,0,0,0,0,0],
      [1,0,0,0,0,0,0,0,0],
      [0,1,0,0,0,0,0,0,0],
      [0,0,1,0,0,0,0,0,0],
      [0,0,1,0,0,0,0,0,0],
      [0,1,0,0,0,0,0,0,0],
      [0,1,0,0,0,0,0,0,0],
      [0,0,0,0,0,0,0,0,0],
      [0,0,1,0,0,0,0,0,0],
      [0,0,1,0,0,0,0,0,0],
      [0,0,0,1,0,0,0,0,0],
      [0,0,0,0,1,0,0,0,0],
      [0,0,0,0,1,0,0,0,0],
      [0,0,0,1,0,0,0,0,0],
      [0,0,1,0,0,0,0,0,0],
      [0,1,0,0,0,0,0,0,0],
      [1,0,0,0,0,0,0,0,0],
      [1,0,0,0,0,0,0,0,0],
      [0,1,0,0,0,0,0,0,0],
      [0,0,1,0,0,0,0,0,0],
      [0,1,0,0,0,0,0,0,0],
      [1,0,0,0,0,0,0,0,0],
      [1,0,0,0,0,0,0,0,0],
      [0,0,0,0,0,0,0,0,0]
    ],
    "ranks": [10, 15, 20]
}
