{
  "name": "12. 小星星 (带和弦版)",
  "patterns": [
    [1, 0, 1, 0, 1, 0, 0, 0, 0],
    [1,0,0,0,0,0,0,0,0],
    [0,0,0,0,1,0,0,0,0],
    [0,0,0,0,1,0,0,0,0],
    [0,0,0,0,0,1,0,0,0],
    [0,0,0,0,0,1,0,0,0],
    [0,0,0,0,1,0,0,0,0],
    [0,0,0,0,0,0,0,0,0],
    [0,0,0,1,0,1,0,1,0],
    [0,0,0,1,0,0,0,0,0],
    [0,0,1,0,0,0,0,0,0],
    [0,0,1,0,0,0,0,0,0],
    [1, 0, 1, 0, 1, 0, 0, 0, 0],
    [0,1,0,0,0,0,0,0,0],
    [1,0,0,0,0,0,0,0,0],
    [0,0,0,0,0,0,0,0,0]
  ],
  "ranks": [20, 30, 40]
}
