{
  "name": "16. 階段",
  "patterns": [
    [0, 0, 0, 0, 1, 1, 1, 1, 1],
    [0, 0, 0, 0, 0, 1, 1, 1, 1],
    [0, 0, 0, 0, 0, 0, 1, 1, 1],
    [0, 0, 0, 0, 0, 0, 0, 1, 1],
    [0, 0, 0, 0, 0, 0, 0, 0, 1],
    [0, 0, 0, 0, 0, 0, 0, 0, 0]
  ],
  "ranks": [2.00, 1.50, 0.97]
}
