{
  "name": "17. 二本一体往復",
  "patterns": [
    [0, 0, 0, 0, 0, 1, 1, 0, 0],
    [0, 0, 0, 0, 0, 0, 1, 1, 0],
    [0, 0, 0, 0, 0, 0, 0, 1, 1],
    [0, 0, 0, 0, 0, 0, 1, 1, 0],
    [0, 0, 0, 0, 0, 1, 1, 0, 0]
  ],
  "ranks": [2.50, 2.00, 1.27]
}
