{
  "name": "19. 網",
  "patterns": [
    [0, 0, 0, 0, 0, 1, 1, 1, 0],
    [0, 0, 0, 0, 1, 0, 1, 0, 1],
    [0, 0, 0, 0, 0, 1, 0, 1, 0],
    [0, 0, 0, 0, 0, 0, 1, 0, 0],
    [0, 0, 0, 0, 0, 0, 0, 0, 0]
  ],
  "ranks": [4.00, 3.00, 2.18]
}
