{
    "name": "2. Odd and Even",
    "patterns": [
        [1,0,0,0,0,0,0,0,0],
        [0,0,1,0,0,0,0,0,0],
        [0,0,0,0,1,0,0,0,0],
        [0,0,0,0,0,0,1,0,0],
        [0,0,0,0,0,0,0,0,1],
        [0,0,0,0,0,0,0,0,1],
        [0,0,0,0,0,0,1,0,0],
        [0,0,0,0,1,0,0,0,0],
        [0,0,1,0,0,0,0,0,0],
        [1,0,0,0,0,0,0,0,0],
        [0,1,0,0,0,0,0,0,0],
        [0,0,0,1,0,0,0,0,0],
        [0,0,0,0,0,1,0,0,0],
        [0,0,0,0,0,0,0,1,0],
        [0,0,0,0,0,0,0,1,0],
        [0,0,0,0,0,1,0,0,0],
        [0,0,0,1,0,0,0,0,0],
        [0,1,0,0,0,0,0,0,0]
    ],
    "ranks": [10, 15, 20]
}
