{
  "name": "20. ランダム1",
  "patterns": [
    [0, 0, 0, 0, 1, 1, 1, 1, 1],
    [0, 0, 0, 0, 0, 0, 0, 0, 0],
    [0, 0, 0, 0, 1, 1, 0, 1, 1],
    [0, 0, 0, 0, 0, 0, 1, 0, 0],
    [0, 0, 0, 0, 1, 0, 1, 1, 0],
    [0, 0, 0, 0, 0, 1, 0, 0, 1],
    [0, 0, 0, 0, 1, 1, 1, 1, 1]
  ],
  "ranks": [5.00, 4.00, 2.80]
}
