{
  "name": "22. 二重往復",
  "patterns": [
    [0, 0, 0, 0, 1, 1, 0, 0, 0],
    [0, 0, 0, 0, 0, 1, 1, 0, 0],
    [0, 0, 0, 0, 0, 0, 1, 1, 0],
    [0, 0, 0, 0, 0, 0, 0, 1, 1],
    [0, 0, 0, 0, 0, 0, 1, 1, 0],
    [0, 0, 0, 0, 0, 1, 1, 0, 0],
    [0, 0, 0, 0, 1, 1, 0, 0, 0]
  ],
  "ranks": [5.00, 4.00, 2.50]
}
