{
  "name": "23. ランダム2",
  "patterns": [
    [0, 0, 0, 0, 1, 1, 1, 1, 1],
    [0, 0, 0, 0, 0, 1, 1, 0, 1],
    [0, 0, 0, 0, 1, 0, 0, 1, 0],
    [0, 0, 0, 0, 0, 1, 0, 0, 1],
    [0, 0, 0, 0, 1, 0, 1, 1, 0],
    [0, 0, 0, 0, 0, 0, 1, 0, 1],
    [0, 0, 0, 0, 1, 1, 0, 1, 0],
    [0, 0, 0, 0, 0, 1, 0, 0, 1],
    [0, 0, 0, 0, 1, 0, 1, 0, 1],
    [0, 0, 0, 0, 0, 1, 1, 1, 0],
    [0, 0, 0, 0, 1, 1, 1, 1, 1]
  ],
  "ranks": [8.00, 6.00, 4.85]
}
