{
  "name": "24. カオス",
  "patterns": [
    [0, 0, 0, 0, 1, 1, 1, 1, 0],
    [0, 0, 0, 0, 0, 1, 1, 0, 0],
    [0, 0, 0, 0, 1, 0, 0, 1, 1],
    [0, 0, 0, 0, 0, 0, 1, 0, 0],
    [0, 0, 0, 0, 1, 1, 0, 1, 1],
    [0, 0, 0, 0, 0, 0, 1, 1, 0],
    [0, 0, 0, 0, 1, 1, 0, 0, 1],
    [0, 0, 0, 0, 0, 1, 1, 0, 0],
    [0, 0, 0, 0, 1, 0, 0, 1, 1],
    [0, 0, 0, 0, 0, 1, 1, 1, 0],
    [0, 0, 0, 0, 1, 0, 0, 0, 1]
  ],
  "ranks": [8.00, 6.00, 4.98]
}
