{
  "name": "25. 無限二重往復",
  "patterns": [
    [0, 0, 0, 0, 1, 1, 0, 0, 0],
    [0, 0, 0, 0, 0, 1, 1, 0, 0],
    [0, 0, 0, 0, 0, 0, 1, 1, 0],
    [0, 0, 0, 0, 0, 0, 0, 1, 1],
    [0, 0, 0, 0, 0, 0, 1, 1, 0],
    [0, 0, 0, 0, 0, 1, 1, 0, 0]
  ],
  "ranks": [10, 20, 30]
}
