{
  "name": "26. まとめ",
  "patterns": [
    [0, 0, 0, 0, 1, 1, 1, 1, 1],
    [0, 0, 0, 0, 0, 0, 0, 0, 0],
    [0, 0, 0, 0, 1, 0, 1, 0, 1],
    [0, 0, 0, 0, 0, 1, 0, 1, 0],
    [0, 0, 0, 0, 1, 1, 1, 1, 1],
    [0, 0, 0, 0, 0, 1, 1, 1, 1],
    [0, 0, 0, 0, 0, 0, 1, 1, 1],
    [0, 0, 0, 0, 0, 0, 0, 1, 1],
    [0, 0, 0, 0, 0, 0, 0, 0, 1],
    [0, 0, 0, 0, 0, 0, 0, 0, 0],
    [0, 0, 0, 0, 0, 1, 1, 0, 0],
    [0, 0, 0, 0, 0, 0, 1, 1, 0],
    [0, 0, 0, 0, 0, 0, 0, 1, 1],
    [0, 0, 0, 0, 0, 0, 1, 1, 0],
    [0, 0, 0, 0, 0, 1, 1, 0, 0],
    [0, 0, 0, 0, 1, 1, 1, 1, 1]
  ],
  "ranks": [10.00, 8.00, 5.50]
}
