{
    "name": "4. Right Hand Melody",
    "patterns": [
        [0,0,0,0,0,1,0,0,0],
        [0,0,0,0,0,0,0,1,0],
        [0,0,0,0,0,0,1,0,0],
        [0,0,0,0,0,0,0,1,0],
        [0,0,0,0,0,0,0,0,1],
        [0,0,0,0,0,0,0,1,0],
        [0,0,0,0,0,1,0,0,0],
        [0,0,0,0,0,0,1,0,0],
        [0,0,0,0,0,0,0,1,0],
        [0,0,0,0,0,1,0,0,0]
    ],
    "ranks": [10, 15, 20]
}
