{
    "name": "5. Spacebar Integration",
    "patterns": [
        [1,0,0,0,0,0,0,0,0],
        [0,0,0,0,1,0,0,0,0],
        [0,0,0,0,0,1,0,0,0],
        [0,0,0,0,1,0,0,0,0],
        [0,1,0,0,0,0,0,0,0],
        [0,0,0,0,1,0,0,0,0],
        [0,0,0,0,0,0,1,0,0],
        [0,0,0,0,1,0,0,0,0],
        [0,0,1,0,0,0,0,0,0],
        [0,0,0,0,1,0,0,0,0],
        [0,0,0,0,0,0,0,1,0],
        [0,0,0,0,1,0,0,0,0]
    ],
    "ranks": [10, 15, 20]
}
