{
    "name": "6. A More Musical Melody",
    "patterns": [
        [1,0,0,0,0,0,0,0,0],
        [0,0,0,0,0,0,1,0,0],
        [0,0,0,0,0,1,0,0,0],
        [0,0,0,0,1,0,0,0,0],
        [0,0,1,0,0,0,0,0,0],
        [0,0,0,0,0,1,0,0,0],
        [0,0,0,0,0,0,0,1,0],
        [0,0,0,0,0,0,0,0,1],
        [0,0,0,0,0,0,0,1,0],
        [0,0,0,0,0,1,0,0,0],
        [0,0,0,0,1,0,0,0,0],
        [0,0,0,0,0,1,0,0,0],
        [0,0,0,0,0,0,1,0,0],
        [0,0,0,0,0,0,0,1,0],
        [0,0,0,0,0,0,0,0,1],
        [0,0,0,0,0,0,0,0,0]
    ],
    "ranks": [12, 18, 24]
}
